110010001111111
010010011110000
011010010100000
001010010100000
101010011100001
111110010111111
000111111100000
000111111111000
000111111001110
000111101100010
111101100110011
000001110010011
000011010010000
000111011111110
111110011010011
