111010000110111
001010001100100
001111111001100
000011111001110
111110011111011
000010011101000
000111111111000
000111111010000
011111001010000
110001111111111
100011110111111
000111000101100
001101000110110
111001000111011
100011000011001
