100010000010111
100010000111110
110010001100000
010010001100000
110010111100001
111111111001111
000011110111000
000011111110000
000001111111000
000111111011111
111111101010011
011111001011100
010110001100100
010010000100110
110010000110010
